openfwi-bucket/Openfwi/CurveVel_B/data/data1.npy	openfwi-bucket/Openfwi/CurveVel_B/model/model1.npy
openfwi-bucket/Openfwi/CurveVel_B/data/data2.npy	openfwi-bucket/Openfwi/CurveVel_B/model/model2.npy
openfwi-bucket/Openfwi/CurveVel_B/data/data3.npy	openfwi-bucket/Openfwi/CurveVel_B/model/model3.npy
openfwi-bucket/Openfwi/CurveVel_B/data/data4.npy	openfwi-bucket/Openfwi/CurveVel_B/model/model4.npy
openfwi-bucket/Openfwi/CurveVel_B/data/data5.npy	openfwi-bucket/Openfwi/CurveVel_B/model/model5.npy
openfwi-bucket/Openfwi/CurveVel_B/data/data6.npy	openfwi-bucket/Openfwi/CurveVel_B/model/model6.npy
openfwi-bucket/Openfwi/CurveVel_B/data/data7.npy	openfwi-bucket/Openfwi/CurveVel_B/model/model7.npy
openfwi-bucket/Openfwi/CurveVel_B/data/data8.npy	openfwi-bucket/Openfwi/CurveVel_B/model/model8.npy
openfwi-bucket/Openfwi/CurveVel_B/data/data9.npy	openfwi-bucket/Openfwi/CurveVel_B/model/model9.npy
openfwi-bucket/Openfwi/CurveVel_B/data/data10.npy	openfwi-bucket/Openfwi/CurveVel_B/model/model10.npy
openfwi-bucket/Openfwi/CurveVel_B/data/data11.npy	openfwi-bucket/Openfwi/CurveVel_B/model/model11.npy
openfwi-bucket/Openfwi/CurveVel_B/data/data12.npy	openfwi-bucket/Openfwi/CurveVel_B/model/model12.npy
openfwi-bucket/Openfwi/CurveVel_B/data/data13.npy	openfwi-bucket/Openfwi/CurveVel_B/model/model13.npy
openfwi-bucket/Openfwi/CurveVel_B/data/data14.npy	openfwi-bucket/Openfwi/CurveVel_B/model/model14.npy
openfwi-bucket/Openfwi/CurveVel_B/data/data15.npy	openfwi-bucket/Openfwi/CurveVel_B/model/model15.npy
openfwi-bucket/Openfwi/CurveVel_B/data/data16.npy	openfwi-bucket/Openfwi/CurveVel_B/model/model16.npy
openfwi-bucket/Openfwi/CurveVel_B/data/data17.npy	openfwi-bucket/Openfwi/CurveVel_B/model/model17.npy
openfwi-bucket/Openfwi/CurveVel_B/data/data18.npy	openfwi-bucket/Openfwi/CurveVel_B/model/model18.npy
openfwi-bucket/Openfwi/CurveVel_B/data/data19.npy	openfwi-bucket/Openfwi/CurveVel_B/model/model19.npy
openfwi-bucket/Openfwi/CurveVel_B/data/data20.npy	openfwi-bucket/Openfwi/CurveVel_B/model/model20.npy
openfwi-bucket/Openfwi/CurveVel_B/data/data21.npy	openfwi-bucket/Openfwi/CurveVel_B/model/model21.npy
openfwi-bucket/Openfwi/CurveVel_B/data/data22.npy	openfwi-bucket/Openfwi/CurveVel_B/model/model22.npy
openfwi-bucket/Openfwi/CurveVel_B/data/data23.npy	openfwi-bucket/Openfwi/CurveVel_B/model/model23.npy
openfwi-bucket/Openfwi/CurveVel_B/data/data24.npy	openfwi-bucket/Openfwi/CurveVel_B/model/model24.npy
openfwi-bucket/Openfwi/CurveVel_B/data/data25.npy	openfwi-bucket/Openfwi/CurveVel_B/model/model25.npy
openfwi-bucket/Openfwi/CurveVel_B/data/data26.npy	openfwi-bucket/Openfwi/CurveVel_B/model/model26.npy
openfwi-bucket/Openfwi/CurveVel_B/data/data27.npy	openfwi-bucket/Openfwi/CurveVel_B/model/model27.npy
openfwi-bucket/Openfwi/CurveVel_B/data/data28.npy	openfwi-bucket/Openfwi/CurveVel_B/model/model28.npy
openfwi-bucket/Openfwi/CurveVel_B/data/data29.npy	openfwi-bucket/Openfwi/CurveVel_B/model/model29.npy
openfwi-bucket/Openfwi/CurveVel_B/data/data30.npy	openfwi-bucket/Openfwi/CurveVel_B/model/model30.npy
openfwi-bucket/Openfwi/CurveVel_B/data/data31.npy	openfwi-bucket/Openfwi/CurveVel_B/model/model31.npy
openfwi-bucket/Openfwi/CurveVel_B/data/data32.npy	openfwi-bucket/Openfwi/CurveVel_B/model/model32.npy
openfwi-bucket/Openfwi/CurveVel_B/data/data33.npy	openfwi-bucket/Openfwi/CurveVel_B/model/model33.npy
openfwi-bucket/Openfwi/CurveVel_B/data/data34.npy	openfwi-bucket/Openfwi/CurveVel_B/model/model34.npy
openfwi-bucket/Openfwi/CurveVel_B/data/data35.npy	openfwi-bucket/Openfwi/CurveVel_B/model/model35.npy
openfwi-bucket/Openfwi/CurveVel_B/data/data36.npy	openfwi-bucket/Openfwi/CurveVel_B/model/model36.npy
openfwi-bucket/Openfwi/CurveVel_B/data/data37.npy	openfwi-bucket/Openfwi/CurveVel_B/model/model37.npy
openfwi-bucket/Openfwi/CurveVel_B/data/data38.npy	openfwi-bucket/Openfwi/CurveVel_B/model/model38.npy
openfwi-bucket/Openfwi/CurveVel_B/data/data39.npy	openfwi-bucket/Openfwi/CurveVel_B/model/model39.npy
openfwi-bucket/Openfwi/CurveVel_B/data/data40.npy	openfwi-bucket/Openfwi/CurveVel_B/model/model40.npy
openfwi-bucket/Openfwi/CurveVel_B/data/data41.npy	openfwi-bucket/Openfwi/CurveVel_B/model/model41.npy
openfwi-bucket/Openfwi/CurveVel_B/data/data42.npy	openfwi-bucket/Openfwi/CurveVel_B/model/model42.npy
openfwi-bucket/Openfwi/CurveVel_B/data/data43.npy	openfwi-bucket/Openfwi/CurveVel_B/model/model43.npy
openfwi-bucket/Openfwi/CurveVel_B/data/data44.npy	openfwi-bucket/Openfwi/CurveVel_B/model/model44.npy
openfwi-bucket/Openfwi/CurveVel_B/data/data45.npy	openfwi-bucket/Openfwi/CurveVel_B/model/model45.npy
openfwi-bucket/Openfwi/CurveVel_B/data/data46.npy	openfwi-bucket/Openfwi/CurveVel_B/model/model46.npy
openfwi-bucket/Openfwi/CurveVel_B/data/data47.npy	openfwi-bucket/Openfwi/CurveVel_B/model/model47.npy
openfwi-bucket/Openfwi/CurveVel_B/data/data48.npy	openfwi-bucket/Openfwi/CurveVel_B/model/model48.npy
