/media/user/Transcend/OpenFWI/CurveVel_A/data/data1.npy	/media/user/Transcend/OpenFWI/CurveVel_A/model/model1.npy
/media/user/Transcend/OpenFWI/CurveVel_A/data/data2.npy	/media/user/Transcend/OpenFWI/CurveVel_A/model/model2.npy
/media/user/Transcend/OpenFWI/CurveVel_A/data/data3.npy	/media/user/Transcend/OpenFWI/CurveVel_A/model/model3.npy
/media/user/Transcend/OpenFWI/CurveVel_A/data/data4.npy	/media/user/Transcend/OpenFWI/CurveVel_A/model/model4.npy
/media/user/Transcend/OpenFWI/CurveVel_A/data/data5.npy	/media/user/Transcend/OpenFWI/CurveVel_A/model/model5.npy
/media/user/Transcend/OpenFWI/CurveVel_A/data/data6.npy	/media/user/Transcend/OpenFWI/CurveVel_A/model/model6.npy
/media/user/Transcend/OpenFWI/CurveVel_A/data/data7.npy	/media/user/Transcend/OpenFWI/CurveVel_A/model/model7.npy
/media/user/Transcend/OpenFWI/CurveVel_A/data/data8.npy	/media/user/Transcend/OpenFWI/CurveVel_A/model/model8.npy
/media/user/Transcend/OpenFWI/CurveVel_A/data/data9.npy	/media/user/Transcend/OpenFWI/CurveVel_A/model/model9.npy
/media/user/Transcend/OpenFWI/CurveVel_A/data/data10.npy	/media/user/Transcend/OpenFWI/CurveVel_A/model/model10.npy
/media/user/Transcend/OpenFWI/CurveVel_A/data/data11.npy	/media/user/Transcend/OpenFWI/CurveVel_A/model/model11.npy
/media/user/Transcend/OpenFWI/CurveVel_A/data/data12.npy	/media/user/Transcend/OpenFWI/CurveVel_A/model/model12.npy
/media/user/Transcend/OpenFWI/CurveVel_A/data/data13.npy	/media/user/Transcend/OpenFWI/CurveVel_A/model/model13.npy
/media/user/Transcend/OpenFWI/CurveVel_A/data/data14.npy	/media/user/Transcend/OpenFWI/CurveVel_A/model/model14.npy
/media/user/Transcend/OpenFWI/CurveVel_A/data/data15.npy	/media/user/Transcend/OpenFWI/CurveVel_A/model/model15.npy
/media/user/Transcend/OpenFWI/CurveVel_A/data/data16.npy	/media/user/Transcend/OpenFWI/CurveVel_A/model/model16.npy
/media/user/Transcend/OpenFWI/CurveVel_A/data/data17.npy	/media/user/Transcend/OpenFWI/CurveVel_A/model/model17.npy
/media/user/Transcend/OpenFWI/CurveVel_A/data/data18.npy	/media/user/Transcend/OpenFWI/CurveVel_A/model/model18.npy
/media/user/Transcend/OpenFWI/CurveVel_A/data/data19.npy	/media/user/Transcend/OpenFWI/CurveVel_A/model/model19.npy
/media/user/Transcend/OpenFWI/CurveVel_A/data/data20.npy	/media/user/Transcend/OpenFWI/CurveVel_A/model/model20.npy
/media/user/Transcend/OpenFWI/CurveVel_A/data/data21.npy	/media/user/Transcend/OpenFWI/CurveVel_A/model/model21.npy
/media/user/Transcend/OpenFWI/CurveVel_A/data/data22.npy	/media/user/Transcend/OpenFWI/CurveVel_A/model/model22.npy
/media/user/Transcend/OpenFWI/CurveVel_A/data/data23.npy	/media/user/Transcend/OpenFWI/CurveVel_A/model/model23.npy
/media/user/Transcend/OpenFWI/CurveVel_A/data/data24.npy	/media/user/Transcend/OpenFWI/CurveVel_A/model/model24.npy
/media/user/Transcend/OpenFWI/CurveVel_A/data/data25.npy	/media/user/Transcend/OpenFWI/CurveVel_A/model/model25.npy
/media/user/Transcend/OpenFWI/CurveVel_A/data/data26.npy	/media/user/Transcend/OpenFWI/CurveVel_A/model/model26.npy
/media/user/Transcend/OpenFWI/CurveVel_A/data/data27.npy	/media/user/Transcend/OpenFWI/CurveVel_A/model/model27.npy
/media/user/Transcend/OpenFWI/CurveVel_A/data/data28.npy	/media/user/Transcend/OpenFWI/CurveVel_A/model/model28.npy
/media/user/Transcend/OpenFWI/CurveVel_A/data/data29.npy	/media/user/Transcend/OpenFWI/CurveVel_A/model/model29.npy
/media/user/Transcend/OpenFWI/CurveVel_A/data/data30.npy	/media/user/Transcend/OpenFWI/CurveVel_A/model/model30.npy
/media/user/Transcend/OpenFWI/CurveVel_A/data/data31.npy	/media/user/Transcend/OpenFWI/CurveVel_A/model/model31.npy
/media/user/Transcend/OpenFWI/CurveVel_A/data/data32.npy	/media/user/Transcend/OpenFWI/CurveVel_A/model/model32.npy
/media/user/Transcend/OpenFWI/CurveVel_A/data/data33.npy	/media/user/Transcend/OpenFWI/CurveVel_A/model/model33.npy
/media/user/Transcend/OpenFWI/CurveVel_A/data/data34.npy	/media/user/Transcend/OpenFWI/CurveVel_A/model/model34.npy
/media/user/Transcend/OpenFWI/CurveVel_A/data/data35.npy	/media/user/Transcend/OpenFWI/CurveVel_A/model/model35.npy
/media/user/Transcend/OpenFWI/CurveVel_A/data/data36.npy	/media/user/Transcend/OpenFWI/CurveVel_A/model/model36.npy
/media/user/Transcend/OpenFWI/CurveVel_A/data/data37.npy	/media/user/Transcend/OpenFWI/CurveVel_A/model/model37.npy
/media/user/Transcend/OpenFWI/CurveVel_A/data/data38.npy	/media/user/Transcend/OpenFWI/CurveVel_A/model/model38.npy
/media/user/Transcend/OpenFWI/CurveVel_A/data/data39.npy	/media/user/Transcend/OpenFWI/CurveVel_A/model/model39.npy
/media/user/Transcend/OpenFWI/CurveVel_A/data/data40.npy	/media/user/Transcend/OpenFWI/CurveVel_A/model/model40.npy
/media/user/Transcend/OpenFWI/CurveVel_A/data/data41.npy	/media/user/Transcend/OpenFWI/CurveVel_A/model/model41.npy
/media/user/Transcend/OpenFWI/CurveVel_A/data/data42.npy	/media/user/Transcend/OpenFWI/CurveVel_A/model/model42.npy
/media/user/Transcend/OpenFWI/CurveVel_A/data/data43.npy	/media/user/Transcend/OpenFWI/CurveVel_A/model/model43.npy
/media/user/Transcend/OpenFWI/CurveVel_A/data/data44.npy	/media/user/Transcend/OpenFWI/CurveVel_A/model/model44.npy
/media/user/Transcend/OpenFWI/CurveVel_A/data/data45.npy	/media/user/Transcend/OpenFWI/CurveVel_A/model/model45.npy
/media/user/Transcend/OpenFWI/CurveVel_A/data/data46.npy	/media/user/Transcend/OpenFWI/CurveVel_A/model/model46.npy
/media/user/Transcend/OpenFWI/CurveVel_A/data/data47.npy	/media/user/Transcend/OpenFWI/CurveVel_A/model/model47.npy
/media/user/Transcend/OpenFWI/CurveVel_A/data/data48.npy	/media/user/Transcend/OpenFWI/CurveVel_A/model/model48.npy
