openfwi-bucket/Openfwi/Style_B/data/data1.npy	openfwi-bucket/Openfwi/Style_B/model/model1.npy
openfwi-bucket/Openfwi/Style_B/data/data2.npy	openfwi-bucket/Openfwi/Style_B/model/model2.npy
openfwi-bucket/Openfwi/Style_B/data/data3.npy	openfwi-bucket/Openfwi/Style_B/model/model3.npy
openfwi-bucket/Openfwi/Style_B/data/data4.npy	openfwi-bucket/Openfwi/Style_B/model/model4.npy
openfwi-bucket/Openfwi/Style_B/data/data5.npy	openfwi-bucket/Openfwi/Style_B/model/model5.npy
openfwi-bucket/Openfwi/Style_B/data/data6.npy	openfwi-bucket/Openfwi/Style_B/model/model6.npy
openfwi-bucket/Openfwi/Style_B/data/data7.npy	openfwi-bucket/Openfwi/Style_B/model/model7.npy
openfwi-bucket/Openfwi/Style_B/data/data8.npy	openfwi-bucket/Openfwi/Style_B/model/model8.npy
openfwi-bucket/Openfwi/Style_B/data/data9.npy	openfwi-bucket/Openfwi/Style_B/model/model9.npy
openfwi-bucket/Openfwi/Style_B/data/data10.npy	openfwi-bucket/Openfwi/Style_B/model/model10.npy
openfwi-bucket/Openfwi/Style_B/data/data11.npy	openfwi-bucket/Openfwi/Style_B/model/model11.npy
openfwi-bucket/Openfwi/Style_B/data/data12.npy	openfwi-bucket/Openfwi/Style_B/model/model12.npy
openfwi-bucket/Openfwi/Style_B/data/data13.npy	openfwi-bucket/Openfwi/Style_B/model/model13.npy
openfwi-bucket/Openfwi/Style_B/data/data14.npy	openfwi-bucket/Openfwi/Style_B/model/model14.npy
openfwi-bucket/Openfwi/Style_B/data/data15.npy	openfwi-bucket/Openfwi/Style_B/model/model15.npy
openfwi-bucket/Openfwi/Style_B/data/data16.npy	openfwi-bucket/Openfwi/Style_B/model/model16.npy
openfwi-bucket/Openfwi/Style_B/data/data17.npy	openfwi-bucket/Openfwi/Style_B/model/model17.npy
openfwi-bucket/Openfwi/Style_B/data/data18.npy	openfwi-bucket/Openfwi/Style_B/model/model18.npy
openfwi-bucket/Openfwi/Style_B/data/data19.npy	openfwi-bucket/Openfwi/Style_B/model/model19.npy
openfwi-bucket/Openfwi/Style_B/data/data20.npy	openfwi-bucket/Openfwi/Style_B/model/model20.npy
openfwi-bucket/Openfwi/Style_B/data/data21.npy	openfwi-bucket/Openfwi/Style_B/model/model21.npy
openfwi-bucket/Openfwi/Style_B/data/data22.npy	openfwi-bucket/Openfwi/Style_B/model/model22.npy
openfwi-bucket/Openfwi/Style_B/data/data23.npy	openfwi-bucket/Openfwi/Style_B/model/model23.npy
openfwi-bucket/Openfwi/Style_B/data/data24.npy	openfwi-bucket/Openfwi/Style_B/model/model24.npy
openfwi-bucket/Openfwi/Style_B/data/data25.npy	openfwi-bucket/Openfwi/Style_B/model/model25.npy
openfwi-bucket/Openfwi/Style_B/data/data26.npy	openfwi-bucket/Openfwi/Style_B/model/model26.npy
openfwi-bucket/Openfwi/Style_B/data/data27.npy	openfwi-bucket/Openfwi/Style_B/model/model27.npy
openfwi-bucket/Openfwi/Style_B/data/data28.npy	openfwi-bucket/Openfwi/Style_B/model/model28.npy
openfwi-bucket/Openfwi/Style_B/data/data29.npy	openfwi-bucket/Openfwi/Style_B/model/model29.npy
openfwi-bucket/Openfwi/Style_B/data/data30.npy	openfwi-bucket/Openfwi/Style_B/model/model30.npy
openfwi-bucket/Openfwi/Style_B/data/data31.npy	openfwi-bucket/Openfwi/Style_B/model/model31.npy
openfwi-bucket/Openfwi/Style_B/data/data32.npy	openfwi-bucket/Openfwi/Style_B/model/model32.npy
openfwi-bucket/Openfwi/Style_B/data/data33.npy	openfwi-bucket/Openfwi/Style_B/model/model33.npy
openfwi-bucket/Openfwi/Style_B/data/data34.npy	openfwi-bucket/Openfwi/Style_B/model/model34.npy
openfwi-bucket/Openfwi/Style_B/data/data35.npy	openfwi-bucket/Openfwi/Style_B/model/model35.npy
openfwi-bucket/Openfwi/Style_B/data/data36.npy	openfwi-bucket/Openfwi/Style_B/model/model36.npy
openfwi-bucket/Openfwi/Style_B/data/data37.npy	openfwi-bucket/Openfwi/Style_B/model/model37.npy
openfwi-bucket/Openfwi/Style_B/data/data38.npy	openfwi-bucket/Openfwi/Style_B/model/model38.npy
openfwi-bucket/Openfwi/Style_B/data/data39.npy	openfwi-bucket/Openfwi/Style_B/model/model39.npy
openfwi-bucket/Openfwi/Style_B/data/data40.npy	openfwi-bucket/Openfwi/Style_B/model/model40.npy
openfwi-bucket/Openfwi/Style_B/data/data41.npy	openfwi-bucket/Openfwi/Style_B/model/model41.npy
openfwi-bucket/Openfwi/Style_B/data/data42.npy	openfwi-bucket/Openfwi/Style_B/model/model42.npy
openfwi-bucket/Openfwi/Style_B/data/data43.npy	openfwi-bucket/Openfwi/Style_B/model/model43.npy
openfwi-bucket/Openfwi/Style_B/data/data44.npy	openfwi-bucket/Openfwi/Style_B/model/model44.npy
openfwi-bucket/Openfwi/Style_B/data/data45.npy	openfwi-bucket/Openfwi/Style_B/model/model45.npy
openfwi-bucket/Openfwi/Style_B/data/data46.npy	openfwi-bucket/Openfwi/Style_B/model/model46.npy
openfwi-bucket/Openfwi/Style_B/data/data47.npy	openfwi-bucket/Openfwi/Style_B/model/model47.npy
openfwi-bucket/Openfwi/Style_B/data/data48.npy	openfwi-bucket/Openfwi/Style_B/model/model48.npy
openfwi-bucket/Openfwi/Style_B/data/data49.npy	openfwi-bucket/Openfwi/Style_B/model/model49.npy
openfwi-bucket/Openfwi/Style_B/data/data50.npy	openfwi-bucket/Openfwi/Style_B/model/model50.npy
openfwi-bucket/Openfwi/Style_B/data/data51.npy	openfwi-bucket/Openfwi/Style_B/model/model51.npy
openfwi-bucket/Openfwi/Style_B/data/data52.npy	openfwi-bucket/Openfwi/Style_B/model/model52.npy
openfwi-bucket/Openfwi/Style_B/data/data53.npy	openfwi-bucket/Openfwi/Style_B/model/model53.npy
openfwi-bucket/Openfwi/Style_B/data/data54.npy	openfwi-bucket/Openfwi/Style_B/model/model54.npy
openfwi-bucket/Openfwi/Style_B/data/data55.npy	openfwi-bucket/Openfwi/Style_B/model/model55.npy
openfwi-bucket/Openfwi/Style_B/data/data56.npy	openfwi-bucket/Openfwi/Style_B/model/model56.npy
openfwi-bucket/Openfwi/Style_B/data/data57.npy	openfwi-bucket/Openfwi/Style_B/model/model57.npy
openfwi-bucket/Openfwi/Style_B/data/data58.npy	openfwi-bucket/Openfwi/Style_B/model/model58.npy
openfwi-bucket/Openfwi/Style_B/data/data59.npy	openfwi-bucket/Openfwi/Style_B/model/model59.npy
openfwi-bucket/Openfwi/Style_B/data/data60.npy	openfwi-bucket/Openfwi/Style_B/model/model60.npy
openfwi-bucket/Openfwi/Style_B/data/data61.npy	openfwi-bucket/Openfwi/Style_B/model/model61.npy
openfwi-bucket/Openfwi/Style_B/data/data62.npy	openfwi-bucket/Openfwi/Style_B/model/model62.npy
openfwi-bucket/Openfwi/Style_B/data/data63.npy	openfwi-bucket/Openfwi/Style_B/model/model63.npy
openfwi-bucket/Openfwi/Style_B/data/data64.npy	openfwi-bucket/Openfwi/Style_B/model/model64.npy
openfwi-bucket/Openfwi/Style_B/data/data65.npy	openfwi-bucket/Openfwi/Style_B/model/model65.npy
openfwi-bucket/Openfwi/Style_B/data/data66.npy	openfwi-bucket/Openfwi/Style_B/model/model66.npy
openfwi-bucket/Openfwi/Style_B/data/data67.npy	openfwi-bucket/Openfwi/Style_B/model/model67.npy
openfwi-bucket/Openfwi/Style_B/data/data68.npy	openfwi-bucket/Openfwi/Style_B/model/model68.npy
openfwi-bucket/Openfwi/Style_B/data/data69.npy	openfwi-bucket/Openfwi/Style_B/model/model69.npy
openfwi-bucket/Openfwi/Style_B/data/data70.npy	openfwi-bucket/Openfwi/Style_B/model/model70.npy
openfwi-bucket/Openfwi/Style_B/data/data71.npy	openfwi-bucket/Openfwi/Style_B/model/model71.npy
openfwi-bucket/Openfwi/Style_B/data/data72.npy	openfwi-bucket/Openfwi/Style_B/model/model72.npy
openfwi-bucket/Openfwi/Style_B/data/data73.npy	openfwi-bucket/Openfwi/Style_B/model/model73.npy
openfwi-bucket/Openfwi/Style_B/data/data74.npy	openfwi-bucket/Openfwi/Style_B/model/model74.npy
openfwi-bucket/Openfwi/Style_B/data/data75.npy	openfwi-bucket/Openfwi/Style_B/model/model75.npy
openfwi-bucket/Openfwi/Style_B/data/data76.npy	openfwi-bucket/Openfwi/Style_B/model/model76.npy
openfwi-bucket/Openfwi/Style_B/data/data77.npy	openfwi-bucket/Openfwi/Style_B/model/model77.npy
openfwi-bucket/Openfwi/Style_B/data/data78.npy	openfwi-bucket/Openfwi/Style_B/model/model78.npy
openfwi-bucket/Openfwi/Style_B/data/data79.npy	openfwi-bucket/Openfwi/Style_B/model/model79.npy
openfwi-bucket/Openfwi/Style_B/data/data80.npy	openfwi-bucket/Openfwi/Style_B/model/model80.npy
openfwi-bucket/Openfwi/Style_B/data/data81.npy	openfwi-bucket/Openfwi/Style_B/model/model81.npy
openfwi-bucket/Openfwi/Style_B/data/data82.npy	openfwi-bucket/Openfwi/Style_B/model/model82.npy
openfwi-bucket/Openfwi/Style_B/data/data83.npy	openfwi-bucket/Openfwi/Style_B/model/model83.npy
openfwi-bucket/Openfwi/Style_B/data/data84.npy	openfwi-bucket/Openfwi/Style_B/model/model84.npy
openfwi-bucket/Openfwi/Style_B/data/data85.npy	openfwi-bucket/Openfwi/Style_B/model/model85.npy
openfwi-bucket/Openfwi/Style_B/data/data86.npy	openfwi-bucket/Openfwi/Style_B/model/model86.npy
openfwi-bucket/Openfwi/Style_B/data/data87.npy	openfwi-bucket/Openfwi/Style_B/model/model87.npy
openfwi-bucket/Openfwi/Style_B/data/data88.npy	openfwi-bucket/Openfwi/Style_B/model/model88.npy
openfwi-bucket/Openfwi/Style_B/data/data89.npy	openfwi-bucket/Openfwi/Style_B/model/model89.npy
openfwi-bucket/Openfwi/Style_B/data/data90.npy	openfwi-bucket/Openfwi/Style_B/model/model90.npy
openfwi-bucket/Openfwi/Style_B/data/data91.npy	openfwi-bucket/Openfwi/Style_B/model/model91.npy
openfwi-bucket/Openfwi/Style_B/data/data92.npy	openfwi-bucket/Openfwi/Style_B/model/model92.npy
openfwi-bucket/Openfwi/Style_B/data/data93.npy	openfwi-bucket/Openfwi/Style_B/model/model93.npy
openfwi-bucket/Openfwi/Style_B/data/data94.npy	openfwi-bucket/Openfwi/Style_B/model/model94.npy
openfwi-bucket/Openfwi/Style_B/data/data95.npy	openfwi-bucket/Openfwi/Style_B/model/model95.npy
openfwi-bucket/Openfwi/Style_B/data/data96.npy	openfwi-bucket/Openfwi/Style_B/model/model96.npy
openfwi-bucket/Openfwi/Style_B/data/data97.npy	openfwi-bucket/Openfwi/Style_B/model/model97.npy
openfwi-bucket/Openfwi/Style_B/data/data98.npy	openfwi-bucket/Openfwi/Style_B/model/model98.npy
openfwi-bucket/Openfwi/Style_B/data/data99.npy	openfwi-bucket/Openfwi/Style_B/model/model99.npy
openfwi-bucket/Openfwi/Style_B/data/data100.npy	openfwi-bucket/Openfwi/Style_B/model/model100.npy
openfwi-bucket/Openfwi/Style_B/data/data101.npy	openfwi-bucket/Openfwi/Style_B/model/model101.npy
openfwi-bucket/Openfwi/Style_B/data/data102.npy	openfwi-bucket/Openfwi/Style_B/model/model102.npy
openfwi-bucket/Openfwi/Style_B/data/data103.npy	openfwi-bucket/Openfwi/Style_B/model/model103.npy
openfwi-bucket/Openfwi/Style_B/data/data104.npy	openfwi-bucket/Openfwi/Style_B/model/model104.npy
openfwi-bucket/Openfwi/Style_B/data/data105.npy	openfwi-bucket/Openfwi/Style_B/model/model105.npy
openfwi-bucket/Openfwi/Style_B/data/data106.npy	openfwi-bucket/Openfwi/Style_B/model/model106.npy
openfwi-bucket/Openfwi/Style_B/data/data107.npy	openfwi-bucket/Openfwi/Style_B/model/model107.npy
openfwi-bucket/Openfwi/Style_B/data/data108.npy	openfwi-bucket/Openfwi/Style_B/model/model108.npy
openfwi-bucket/Openfwi/Style_B/data/data109.npy	openfwi-bucket/Openfwi/Style_B/model/model109.npy
openfwi-bucket/Openfwi/Style_B/data/data110.npy	openfwi-bucket/Openfwi/Style_B/model/model110.npy
openfwi-bucket/Openfwi/Style_B/data/data111.npy	openfwi-bucket/Openfwi/Style_B/model/model111.npy
openfwi-bucket/Openfwi/Style_B/data/data112.npy	openfwi-bucket/Openfwi/Style_B/model/model112.npy
openfwi-bucket/Openfwi/Style_B/data/data113.npy	openfwi-bucket/Openfwi/Style_B/model/model113.npy
openfwi-bucket/Openfwi/Style_B/data/data114.npy	openfwi-bucket/Openfwi/Style_B/model/model114.npy
openfwi-bucket/Openfwi/Style_B/data/data115.npy	openfwi-bucket/Openfwi/Style_B/model/model115.npy
openfwi-bucket/Openfwi/Style_B/data/data116.npy	openfwi-bucket/Openfwi/Style_B/model/model116.npy
openfwi-bucket/Openfwi/Style_B/data/data117.npy	openfwi-bucket/Openfwi/Style_B/model/model117.npy
openfwi-bucket/Openfwi/Style_B/data/data118.npy	openfwi-bucket/Openfwi/Style_B/model/model118.npy
openfwi-bucket/Openfwi/Style_B/data/data119.npy	openfwi-bucket/Openfwi/Style_B/model/model119.npy
openfwi-bucket/Openfwi/Style_B/data/data120.npy	openfwi-bucket/Openfwi/Style_B/model/model120.npy
